Ğ	
ğ	
Ş	Ш
ş	ш
Ya	Я
ya	я
C	Дж
c	дж
Ü	Ю
ü	ю
Ç	Ч
ç	ч
I	Ъ
ı	ъ
Ö	Ьо
ö	ьо
B	Б
b	б
A	А
a	а
D	Д
d	д
E	Е
e	е
F	Ф
f	ф
G	Г
g	г
H	Х
h	х
İ	И
i	и
J	Ж
j	ж
K	К
k	к
L	Л
l	л
M	М
m	м
N	Н
n	н
O	О
o	о
P	П
p	п
R	Р
r	р
S	С
s	с
T	Т
t	т
U	У
u	у
V	В
v	в
Y	Й
y	й
Z	З
z	з
Â	А
â	а
Î	И
î	и
Û	У
û	у
“	»
”	«
‘	›
’	‹
`	›